#########
#@----3-#
#-------#
#-------#
#-------#
#------&#
#########