####################################
#----------------------------------#
#----$--#####----------#####-------#
#-------#-------##--------------####
#---------------##----------&------#
#---------#################--------#
#----&--------@-###--------&-------#
#-------#-------###-----######-----#
#-------#--------------------------#
#-----#####-------------######-----#
#-------------&------------&-------#
####################################