#########
#@----2-#
#-------#
#-------#
#-------#
#------&#
#########