########################################
#-------------------#------------------#
#---##------###-----#---###-----##-----#
#---##------###-----#---###-----##-----#
#--------------------------------------#
#---##------#----#####---------####----#
#-----------#------#------#------------#
#-----------###----#-----##------------#
#########---#-------------#----#########
#---------------#---#------------------#
#########---###----------###---#########
#-------------#&   &    &#-------------#
#----------###----###------------------#
#########---#--------------#---#########
#---------------#---#--------------#---#
#########---#----#####-----#---#########
#------------------#-------------------#
#-----###---###----#--------####-------#
#-------#--------- @-----------#-------#
###-----#---#----#####--#------#-----###
#-----------#------#----#--------------#
#---##-----#######---#------#######----#
#--------------------------------------#
########################################