########################################
#-------------------#------------------#
#---###########-----#---###-----##-----#
#---###########-----#---###-----##-----#
#--------------------------------------#
#---##------#----#####----#----####----#
#---##------#-------------#-------#----#
#-----------###############------------#
#########---#-------------#----##------#
#--------------------------------------#
#########---###----------###---#########
#----#--------#&   &    &#---------#---#
#---------- ################-----------#
#########---#--------------#---#########
#---------------#---#------#-------#---#
#########--------#####-----#---#########
#------------------#---------------##--#
#-----###---###----#--------####-------#
#-------#----------@-----------#-------#
###-----#---#----#####--#------#-----###
#-----------#------#----#--------------#
#---###-----#####-------#--- #######---#
#-----------------------#--------------#
#-------------------#------------------#
#---###########-----#---###-----##-----#
#---###########-----#---###-----##-----#
#--------------------------------------#
#########---#------#-------#---#########
#---------------#---#------#-------#---#
#########---#----#####-----#---#########
#------------------#---------------##--#
#-----###---###----#--------####-------#
#-------#----------------------#-------#
###-----#---#----#####--#------#-----###
#-----------#------#----#--------------#
#---###-----#####-------#--- #######---#
#-----------------------#--------------#
########################################